1111111111111111111111111111111111
1E0000000000000C00000C000000000101
1000010100100000101001000100010101
1011110010101010001001000000010101
1P0000000C00C0000000000001000001C1
1111111111111111111111111111111111
